1111111
11E01C1
110C101
1P00101
1111111
