11111111111111111111111111111111111111111111111111111111111111111111
10000C00000000000000000000000000011111111111111111111111111111111111
100000000000000000000000000C0000011111111111111111111111111111111111
10100101001000001010010000000101011111111111111111111111111111111111
10000000000000000000000000000000011111111111111111111111111111111111
100000000000000000000C0000000000011111111111111111111111111111111111
100000C0000000000000000000000000011111111111111111111111111111111111
1E000000000000000000000000000000011111111111111111111111111111111111
10100101001000001010010000000101011111111111111111111111111111111111
10100100101010100010010000000101011111111111111111111111111111111111
10100100101010100010010000000101011111111111111111111111111111111111
10100100101010100010010000000101011111111111111111111111111111111111
1P0000000C0000000000000000000000011111111111111111111111111111111111
100000000000000000C0000000000000011111111111111111111111111111111111
10000000000000000000000000000000011111111111111111111111111111111111
10100101001000001010010000000101011111111111111111111111111111111111
10100101001000001010010000000101011111111111111111111111111111111111
100000000000C0000000000000000000011111111111111111111111111111111111
11111111111111111111111111111111111111111111111111111111111111111111
11111111111111111111111111111111111111111111111111111111111111111111
11111111111111111111111111111111111111111111111111111111111111111111
11111111111111111111111111111111111111111111111111111111111111111111
11111111111111111111111111111111111111111111111111111111111111111111
11111111111111111111111111111111111111111111111111111111111111111111
11111111111111111111111111111111111111111111111111111111111111111111
11111111111111111111111111111111111111111111111111111111111111111111
11111111111111111111111111111111111111111111111111111111111111111111
11111111111111111111111111111111111111111111111111111111111111111111
11111111111111111111111111111111111111111111111111111111111111111111
11111111111111111111111111111111111111111111111111111111111111111111
11111111111111111111111111111111111111111111111111111111111111111111
11111111111111111111111111111111111111111111111111111111111111111111
11111111111111111111111111111111111111111111111111111111111111111111
11111111111111111111111111111111111111111111111111111111111111111111
11111111111111111111111111111111111111111111111111111111111111111111